Alabama: Florida, Georgia, Tennessee, Mississippi, 
Florida: Alabama, Georgia, 
Arizona: California, Utah, Nevada, Colorado, NewMexico, 
California: Arizona, Nevada, Oregon, 
Utah: Arizona, Nevada, Colorado, Wyoming, Idaho, NewMexico, 
Arkansas: Oklahoma, Missouri, Tennessee, Louisiana, Mississippi, Texas, 
Oklahoma: Arkansas, Colorado, Missouri, Kansas, NewMexico, Texas, 
Nevada: Arizona, California, Utah, Idaho, Oregon, 
Colorado: Arizona, Utah, Oklahoma, Nebraska, Wyoming, Kansas, NewMexico, 
Nebraska: Colorado, Wyoming, Missouri, Iowa, Kansas, SouthDakota, 
Wyoming: Utah, Colorado, Nebraska, Idaho, SouthDakota, Montana, 
Delaware: Maryland, Pennsylvania, NewJersey, 
Maryland: Delaware, Pennsylvania, Virginia, WestVirginia, 
Georgia: Alabama, Florida, SouthCarolina, Tennessee, NorthCarolina, 
SouthCarolina: Georgia, NorthCarolina, 
Idaho: Utah, Nevada, Wyoming, Oregon, Montana, Washington, 
Oregon: California, Nevada, Idaho, Washington, 
Illinois: Indiana, Missouri, Michigan, Iowa, Kentucky, Wisconsin, 
Indiana: Illinois, Michigan, Kentucky, Ohio, 
Missouri: Arkansas, Oklahoma, Nebraska, Illinois, Iowa, Kansas, Kentucky, Tennessee, 
Michigan: Illinois, Indiana, Wisconsin, Minnesota, Ohio, 
Iowa: Nebraska, Illinois, Missouri, Wisconsin, Minnesota, SouthDakota, 
Kansas: Oklahoma, Colorado, Nebraska, Missouri, 
Kentucky: Illinois, Indiana, Missouri, Tennessee, Ohio, Virginia, WestVirginia, 
Tennessee: Alabama, Arkansas, Georgia, Missouri, Kentucky, Mississippi, NorthCarolina, Virginia, 
Louisiana: Arkansas, Mississippi, Texas, 
Mississippi: Alabama, Arkansas, Tennessee, Louisiana, 
Pennsylvania: Delaware, Maryland, NewJersey, NewYork, Ohio, WestVirginia, 
Massachusetts: NewHampshire, NewYork, Connecticut, RhodeIsland, Vermont, 
NewHampshire: Massachusetts, Vermont, Maine
Wisconsin: Illinois, Michigan, Iowa, Minnesota, 
Minnesota: Michigan, Iowa, Wisconsin, SouthDakota, NorthDakota, 
SouthDakota: Nebraska, Wyoming, Iowa, Minnesota, Montana, NorthDakota, 
Montana: Wyoming, Idaho, SouthDakota, NorthDakota, 
NewJersey: Delaware, Pennsylvania, NewYork, 
NewMexico: Arizona, Utah, Oklahoma, Colorado, Texas, 
NewYork: Pennsylvania, Massachusetts, NewJersey, Connecticut, RhodeIsland, Vermont, 
Connecticut: Massachusetts, NewYork, RhodeIsland, 
RhodeIsland: Massachusetts, NewYork, Connecticut, 
NorthCarolina: Georgia, SouthCarolina, Tennessee, Virginia, 
NorthDakota: Minnesota, SouthDakota, Montana, 
Ohio: Indiana, Michigan, Kentucky, Pennsylvania, WestVirginia, 
Virginia: Maryland, Kentucky, Tennessee, NorthCarolina, WestVirginia, 
Texas: Arkansas, Oklahoma, Louisiana, NewMexico, 
Vermont: Massachusetts, NewHampshire, NewYork, 
Washington: Idaho, Oregon, 
WestVirginia: Maryland, Kentucky, Pennsylvania, Ohio, Virginia, 
Maine: NewHampshire, 
